1 1 1 1 1 1 4 4 4 4 4 4 4 4 4 4 
1 2 3 4 5 6 7 8 9 0 1 2 3 4 5 6  
4 4 4 4 4 4 4 4 4 4 4 4 4 4 4 4  
4 4 4 4 4 4 4 4 4 4 4 4 4 4 4 4 
4 4 4 4 4 4 4 4 4 4 4 4 4 4 4 4  
4 4 4 4 4 4 4 4 4 4 4 4 4 4 4 4  
4 4 4 4 4 4 4 4 4 4 4 4 4 4 4 4  
4 4 4 4 4 4 4 4 1 1 1 1 1 4 4 4  
4 4 4 4 4 4 4 4 1 3 3 3 1 4 4 4 
4 4 4 4 4 4 4 4 1 3 3 3 1 4 4 4  
4 4 4 4 4 4 4 4 1 3 3 3 1 4 4 4  
4 4 4 4 4 4 4 4 1 3 3 3 1 4 4 4  